Азрян Андраник Агванович	azryan	fphzn
Бясти Милена Борисовна	byasti	bzcnb
Горелкин Никита Дмитриевич	gorelkin	ujhtk
Дё Светлана Викторовна	dyo	cdtnf
Дмитриева Валерия Павловна	dmitrieva	lvbnh
Донченко Виктория Олеговна	donchenko	ljyxt
Зверева Мария Андреевна	zvereva	pdtht
Конышев Дмитрий Анатольевич	konyshev	rjysi
Кузнецов Егор Юрьевич	kuznecov	repyt
Логинова Виктория Сергеевна	loginova	kjuby
Мамедова Нурлана Эльдаровна	mamedova	vfvtl
Машковцева Владислава Алексеевна	mashkovceva	vfirj
Минько Иван Сергеевич	minyko	vbymr
Морев Владислав Сергеевич	morev	vjhtd
Нещеретний Даниил Андреевич	nescheretniy	ytoth
Нигомедзянов Руслан Фаязович	nigometzyanov	ybujv
Одилжанов Хожиакбар Илёс Угли	odiljanov	jlbkf
Разумейченко Богдан Андреевич	razumeychenko	hfpev
Старков Илья Игоревич	starkov	cnfhr
Умеров Алихан Аббосович	umerov	evthj
Уруджева Алина Джалалиевна	urudjeva	ehelt
Хаткевич Дмитрий Анатольевич	hatkevich	fnrtd
Шейн Натан Юрьевич	sheyn	itqyy
Юркова Карина Романовна	yurkova	hrjdf
Горелкина Татьяна Романовна	gorelkinatr	nfnmzyf
Разумейченко Светлана Викторовна	razumsv	razum
Дегтярева Юлия Валерьевна	degtyarevayuv	rkfccyfz

